{
    "height":49,
    "width":25,
    "cam_bump":230,
    "doors":[939, 940, -11, -10, -9],
    "door_info":[{
      "map": 3,
      "x": 434,"y": 1206,
      "destx":414,"desty":36
    },
      {
      "map": 3,
      "x":466,"y":1206,
      "destx":456,"desty":36

    },
    {
      "map": 8,
      "x":426,"y":-26,
      "destx":936,"desty":660

    },
    {
      "map": 8,
      "x":426,"y":-26,
      "destx":978,"desty":660

    },
    {
      "map": 8,
      "x":484,"y":-26,
      "destx":1014,"desty":660

    }
    ],
    "layer0":[1,1,1,1,1,1,1,1,1,1,1,1,91,92,92,93,1,1,1,1,1,1,1,1,1,
1,1,1,1,1,1,1,1,1,1,1,1,91,92,92,93,1,1,1,1,1,1,1,1,1,
1,1,1,1,1,1,1,1,1,1,1,1,91,92,92,93,1,1,1,1,1,1,1,1,1,
1,1,1,1,1,1,1,1,1,1,1,1,91,92,92,93,1,1,1,1,1,1,1,1,1,
1,1,1,1,1,1,1,1,1,1,1,1,91,92,92,93,1,1,1,1,1,1,1,1,1,
1,1,1,1,1,1,1,1,1,1,1,1,91,92,92,93,1,1,1,1,1,1,1,1,1,
1,1,1,1,1,1,1,1,1,1,1,1,91,92,92,93,1,1,1,1,1,1,1,1,1,
1,1,1,1,1,1,1,1,1,1,1,1,91,92,92,93,1,1,1,1,1,1,1,1,1,
1,1,1,1,1,1,1,1,1,1,1,1,91,92,92,93,1,1,1,1,1,1,1,1,1,
1,1,1,1,1,1,1,1,1,1,1,1,91,92,92,93,1,1,1,1,1,1,1,1,1,
1,1,1,1,1,1,1,1,1,1,1,1,91,92,92,93,1,1,1,1,1,1,1,1,1,
1,1,1,1,1,1,1,1,1,1,1,1,91,92,92,93,1,1,1,1,1,1,1,1,1,
1,1,1,1,1,1,1,1,1,1,1,1,91,92,92,93,1,1,1,1,1,1,1,1,1,
1,1,1,1,1,1,1,1,1,1,1,1,91,92,92,93,1,1,1,1,1,1,1,1,1,
1,1,1,1,1,1,1,1,1,1,1,1,91,92,92,93,1,1,1,1,1,1,1,1,1,
1,1,1,1,1,1,1,1,1,1,1,1,91,92,92,93,1,1,1,1,1,1,1,1,1,
1,1,1,1,1,1,1,1,1,1,1,1,91,92,92,93,1,1,1,1,1,1,1,1,1,
1,1,1,1,1,1,1,1,1,1,1,1,91,92,92,93,1,1,1,1,1,1,1,1,1,
1,1,1,1,1,1,1,1,1,1,1,1,91,92,92,93,1,1,1,1,1,1,1,1,1,
1,1,1,1,1,1,1,1,1,1,1,1,91,92,92,93,1,1,1,1,1,1,1,1,1,
1,1,1,1,1,1,1,1,1,1,1,1,91,92,92,93,1,1,1,1,1,1,1,1,1,
1,1,1,1,1,1,1,1,1,1,1,1,91,92,92,93,1,1,1,1,1,1,1,1,1,
1,1,1,1,1,1,1,1,1,1,1,1,91,92,92,93,1,1,1,1,1,1,1,1,1,
1,1,1,1,1,1,1,1,1,1,1,1,91,92,92,93,1,1,1,1,1,1,1,1,1,
1,1,1,1,1,1,1,1,1,1,1,1,91,92,92,93,1,1,1,1,1,1,1,1,1,
1,1,1,1,1,1,1,1,1,1,1,1,91,92,92,93,1,1,1,1,1,1,1,1,1,
1,1,1,1,1,1,1,1,1,1,1,1,91,92,92,93,1,1,1,1,1,1,1,1,1,
1,1,1,1,1,1,1,1,1,1,1,1,91,92,92,93,1,1,1,1,1,1,1,1,1,
1,1,1,1,1,1,1,1,1,1,1,1,91,92,92,93,1,1,1,1,1,1,1,1,1,
1,1,1,1,1,1,1,1,1,1,1,1,91,92,92,93,1,1,1,1,1,1,1,1,1,
1,1,1,1,1,1,1,1,1,1,1,1,91,92,92,93,1,1,1,1,1,1,1,1,1,
1,1,1,1,1,1,1,1,1,1,1,1,91,92,92,93,1,1,1,1,1,1,1,1,1,
1,1,1,1,1,1,1,1,1,1,1,1,91,92,92,93,1,1,1,1,1,1,1,1,1,
1,1,1,1,1,1,1,1,1,1,1,1,91,92,92,93,1,1,1,1,1,1,1,1,1,
1,1,1,1,1,1,1,1,1,1,1,1,91,92,92,93,1,1,1,1,1,1,1,1,1,
1,1,1,1,1,1,1,1,1,1,1,1,91,92,92,93,1,1,1,1,1,1,1,1,1,
1,1,1,1,1,1,1,1,1,1,1,1,71,72,72,73,1,1,1,1,1,1,1,1,1,
1,1,1,1,1,1,1,1,330,331,332,333,334,335,336,337,1,1,1,1,1,1,1,1,1,
1,1,1,1,1,1,1,1,310,311,312,313,314,315,316,317,1,1,1,1,1,1,1,1,1,
1,1,1,1,1,1,1,1,290,291,292,293,294,295,296,297,1,1,1,1,1,1,1,1,1,
1,1,1,1,1,1,1,1,270,271,272,273,274,275,276,277,1,1,1,1,1,1,1,1,1,
1,1,1,1,1,1,1,1,250,251,252,253,254,255,256,257,1,1,1,1,1,1,1,1,1,
1,1,1,1,1,1,1,1,230,231,232,233,234,235,236,237,1,1,1,1,1,1,1,1,1,
1,1,1,1,1,1,1,1,210,211,212,213,214,215,216,217,1,1,1,1,1,1,1,1,1,
1,1,1,1,1,1,1,1,1,1,1,193,194,195,196,197,1,1,1,1,1,1,1,1,1,
1,1,1,1,1,1,1,1,1,1,1,173,174,175,176,177,1,1,1,1,1,1,1,1,1,
1,1,1,1,1,1,1,1,1,1,1,1,1,1,1,1,1,1,1,1,1,1,1,1,1,
1,1,1,1,1,1,1,1,1,1,1,1,1,1,1,1,1,1,1,1,1,1,1,1,1,
1,1,1,1,1,1,1,1,1,1,1,1,1,1,1,1,1,1,1,1,1,1,1,1,1

],
"layer1": [],
"layer2":[]
}