{
    "height":26,
    "width":26,
    "cam_bump":230,
    "doors":[431, 432],
    "door_info":[{
      "map": 3,
      "x": 432,
      "y": 16,
      "dir": [0, 1]},
      {
      "map": 3,
      "x": 432,
      "y": 16,
      "dir": [0, 1]}
    ],
    "layer0":[1,1,1,1,1,1,1,1,1,1,1,1,1,91,92,92,93,1,1,1,1,1,1,1,1,1,1,1,1,1,1,1,1,1,1,1,1,1,1,91,92,92,93,1,1,1,1,1,1,1,1,1,
1,1,1,1,1,1,1,1,1,1,1,1,1,91,92,92,93,1,1,1,1,1,1,1,1,1,
1,1,1,1,1,1,1,1,1,1,1,1,1,91,92,92,93,1,1,1,1,1,1,1,1,1,
1,1,1,1,1,1,1,1,1,1,1,1,1,91,92,92,93,1,1,1,1,1,1,1,1,1,
1,1,1,1,1,1,1,1,1,1,1,1,1,91,92,92,93,1,1,1,1,1,1,1,1,1,
1,1,1,1,1,1,1,1,1,1,1,1,1,91,92,92,93,1,1,1,1,1,1,1,1,1,
1,1,1,1,1,1,1,1,1,1,1,1,1,91,92,92,93,1,1,1,1,1,1,1,1,1,
1,1,1,1,1,1,1,1,1,1,1,1,1,91,92,92,93,1,1,1,1,1,1,1,1,1,
1,1,1,1,1,1,1,1,1,1,1,1,1,91,92,92,93,1,1,1,1,1,1,1,1,1,
1,1,1,1,1,1,1,1,1,1,1,1,1,91,92,92,93,1,1,1,1,1,1,1,1,1,
1,1,1,1,1,1,1,1,1,1,1,1,1,91,92,92,93,1,1,1,1,1,1,1,1,1,
1,1,1,1,1,1,1,1,1,1,1,1,1,91,92,92,93,1,1,1,1,1,1,1,1,1,
1,1,1,1,1,1,1,1,1,1,1,1,1,91,92,92,93,1,1,1,1,1,1,1,1,1,
1,1,1,1,1,1,1,1,1,1,1,1,1,91,92,92,93,1,1,1,1,1,1,1,1,1,
1,1,1,1,1,1,1,1,1,1,1,1,1,71,72,72,73,1,1,1,1,1,1,1,1,1,
1,1,1,1,1,1,1,1,1,330,331,332,333,334,335,336,337,1,1,1,1,1,1,1,1,1,
1,1,1,1,1,1,1,1,1,310,311,312,313,314,315,316,317,1,1,1,1,1,1,1,1,1,
1,1,1,1,1,1,1,1,1,290,291,292,293,294,295,296,297,1,1,1,1,1,1,1,1,1,
1,1,1,1,1,1,1,1,1,270,271,272,273,274,275,276,277,1,1,1,1,1,1,1,1,1,
1,1,1,1,1,1,1,1,1,250,251,252,253,254,255,256,257,1,1,1,1,1,1,1,1,1,
1,1,1,1,1,1,1,1,1,230,231,232,233,234,235,236,237,1,1,1,1,1,1,1,1,1,
1,1,1,1,1,1,1,1,1,1,1,1,1,214,215,216,217,1,1,1,1,1,1,1,1,1,
1,1,1,1,1,1,1,1,1,1,1,1,1,194,195,196,197,1,1,1,1,1,1,1,1,1,
1,1,1,1,1,1,1,1,1,1,1,1,1,174,175,176,177,1,1,1,1,1,1,1,1,1,
1,1,1,1,1,1,1,1,1,1,1,1,1,1,1,1,1,1,1,1,1,1,1,1,1,1

],
"layer1": [],
"layer2":[]
}