{
    "height":27,
    "width":27,
    "cam_bump":0,
    "doors":[-40, -39],
    "interact":[365, 366, 307, 235, 315, 316],
    "interact_id":[1,1, 2,3, 4, 5],  
    "interact_infos":[
    {"type":"event","event":"enddream", "content":[{"text":"Time to wake up.","face":"p_lookdown"}]},
    {"type":"text","content":[{"text":"It's a strange plush toy. It appears to have been well loved.","face":""}, {"text":"That plush looks a lot like mine...","face":"p_lookahead"}, {"text":"huh.","face":"p_interested"}]},
    {"type":"text","content":[{"text":"There's a note.","face":""},{"text":"On the page, a message has been scrawled.","face":""},
      {"text":"It reads 'Sad. I'm so, so sad'.","face":""}, {"text":"Whoever wrote this really needs to see a therapist.","face":"p_lookdown"}]},
    {"type":"text","content":[{"text":"It's a set of drawers.","face":""},{"text":"The drawers are full to the brim with pieces of paper scrawled with mesasges.","face":""}]},
    {"type":"text","content":[{"text":"It's another set of drawers.","face":""},{"text":"This one's drawers contain some blue plush toys.","face":""}]}    
  ],

    "door_info":[{
      "map": 2,
      "x":434,"y":-44, "destx":430,"desty":1136
      
    },
    {
      "map": 2,
      "x":466,"y":-44, "destx":466,"desty":1136
      
    }],
    "entities":[
      {"id":"mouws","x":322,"y":280,"size":28,"interact_events":[
      {"type":"text", "content":[{"text":"Stay calm, okay?","face":"mouws"},{"text":"..?","face":"p_lookahead"}, {"text":"Just don't hurt Sack.","face":"mouws"}, {"text":"What?","face":"p_interested"},{"text":"He's dealt with enough already.","face":"mouws_up"}, {"text":"Okay..?","face":"p_lookahead"}]}
    ]},
    {"id":"sack","x":450,"y":388,"size":32,"interact_events":[
      {"type":"text", "content":[{"text":"Excuse me,","face":"p_lookahead"}, {"text":"...","face":"sack"}]},{"type":"text", "content":[{"text":"Hello?","face":"p_lookahead"}, {"text":".....","face":"sack"}, {"text":"Hey, I need you to move.","face":"p_interested"}, {"text":"......","face":"sack"}]},{"type":"text", "content":[{"text":"Seriously, I need you to move. I need to get through here.","face":"p_somber"}, {"text":".......","face":"sack"}]},
      {"type":"text", "content":[{"text":"..........","face":"sack"}, {"text":"(I'm going to need to use force.)","face":"p_depressed"}]}, 
      {"type":"event", "event":"sackfight", "content":[{"text":"Alright. I've had enough.","face":"p_somber"}, {"text":"...","face":"saddersack"}]}
    ]}
    ],
    "layer0":[1,1,1,1,1,1,1,1,1,1,1,1,146,142,144,186,1,1,1,1,1,1,1,1,1,1,0,
1,1,1,1,1,1,1,1,1,1,1,1,146,142,144,186,1,1,1,1,1,1,1,1,1,1,0,
1,1,1,1,1,1,1,1,1,1,1,1,146,142,144,186,1,1,1,1,1,1,1,1,1,1,0,
1,1,1,1,1,1,1,1,1,1,1,1,146,142,144,186,1,1,1,1,1,1,1,1,1,1,0,
1,1,1,1,1,1,1,1,1,1,1,1,146,142,144,186,1,1,1,1,1,1,1,1,1,1,0,
1,1,1,1,1,1,1,1,1,1,1,1,146,142,144,186,1,1,1,1,1,1,1,1,1,1,0,
1,1,1,1,1,1,1,1,1,1,1,1,146,142,144,186,1,1,1,1,1,1,1,1,1,1,0,
1,1,1,1,1,1,1,1,1,1,1,1,146,142,144,186,1,1,1,1,1,1,1,1,1,1,0,
1,1,1,1,1,1,1,1,222,163,163,163,163,143,143,163,163,163,163,223,1,1,1,1,1,1,0,
1,1,1,1,1,1,1,1,202,143,143,143,143,143,143,143,143,143,143,203,1,1,1,1,1,1,0,
1,1,1,1,1,1,1,1,202,143,143,143,143,143,143,143,143,143,143,203,1,1,1,1,1,1,0,
1,1,1,1,1,1,1,1,202,143,143,143,143,143,143,143,143,143,143,203,1,1,1,1,1,1,0,
1,1,1,1,1,1,1,1,182,123,123,123,123,123,123,123,123,123,123,183,1,1,1,1,1,1,0,
1,1,1,1,1,1,1,1,393,396,396,396,396,396,396,396,396,396,396,394,1,1,1,1,1,1,0,
1,1,1,1,1,1,1,1,373,376,376,376,376,376,376,376,376,376,376,374,1,1,1,1,1,1,0,
1,1,1,1,1,1,1,1,373,376,376,376,376,376,376,376,376,376,376,374,1,1,1,1,1,1,0,
1,1,1,1,1,1,1,1,353,356,356,356,356,356,356,356,356,356,356,354,1,1,1,1,1,1,0,
1,1,1,1,1,1,1,1,1,1,1,1,1,1,1,1,1,1,1,1,1,1,1,1,1,1,0,
1,1,1,1,1,1,1,1,1,1,1,1,1,1,1,1,1,1,1,1,1,1,1,1,1,1,0,
1,1,1,1,1,1,1,1,1,1,1,1,1,1,1,1,1,1,1,1,1,1,1,1,1,1,0,
1,1,1,1,1,1,1,1,1,1,1,1,1,1,1,1,1,1,1,1,1,1,1,1,1,1,0,
1,1,1,1,1,1,1,1,1,1,1,1,1,1,1,1,1,1,1,1,1,1,1,1,1,1,0,
1,1,1,1,1,1,1,1,1,1,1,1,1,1,1,1,1,1,1,1,1,1,1,1,1,1,0,
1,1,1,1,1,1,1,1,1,1,1,1,1,1,1,1,1,1,1,1,1,1,1,1,1,1,0,
1,1,1,1,1,1,1,1,1,1,1,1,1,1,1,1,1,1,1,1,1,1,1,1,1,1,0,
1,1,1,1,1,1,1,1,1,1,1,1,1,1,1,1,1,1,1,1,1,1,1,1,1,1,0,
0,0,0,0,0,0,0,0,0,0,0,0,0,0,0,0,0,0,0,0,0,0,0,0,0,0,0

],
"layer1": [1,1,1,1,1,1,1,1,1,1,1,1,1,1,1,1,1,1,1,1,1,1,1,1,1,1,0,
1,1,1,1,1,1,1,1,1,1,1,1,1,1,1,1,1,1,1,1,1,1,1,1,1,1,0,
1,1,1,1,1,1,1,1,1,1,1,1,1,1,1,1,1,1,1,1,1,1,1,1,1,1,0,
1,1,1,1,1,1,1,1,1,1,1,1,1,1,1,1,1,1,1,1,1,1,1,1,1,1,0,
1,1,1,1,1,1,1,1,1,1,1,1,1,1,1,1,1,1,1,1,1,1,1,1,1,1,0,
1,1,1,1,1,1,1,1,1,1,1,1,1,1,1,1,1,1,1,1,1,1,1,1,1,1,0,
1,1,1,1,1,1,1,1,1,1,1,1,1,1,1,1,1,1,1,1,1,1,1,1,1,1,0,
1,1,1,1,1,1,1,1,1,1,1,1,1,1,1,1,1,1,1,1,1,1,1,1,1,1,0,
1,1,1,1,1,1,1,1,1,1,1,1,1,1,1,1,1,1,192,1,1,1,1,1,1,1,0,
1,1,1,1,1,1,1,1,1,1,1,1,1,1,1,1,1,1,1,1,1,1,1,1,1,1,0,
1,1,1,1,1,1,1,1,1,1,1,1,1,1,1,1,1,1,1,1,1,1,1,1,1,1,0,
1,1,1,1,1,1,1,1,1,190,1,1,1,1,1,1,1,150,150,1,1,1,1,1,1,1,0,
1,1,1,1,1,1,1,1,1,1,1,1,1,123,123,1,1,130,130,1,1,1,1,1,1,1,0,
1,1,1,1,1,1,1,1,1,1,1,1,398,399,400,401,1,1,1,1,1,1,1,1,1,1,0,
1,1,1,1,1,1,1,1,1,1,1,1,378,379,380,381,1,1,1,1,1,1,1,1,1,1,0,
1,1,1,1,1,1,1,1,1,1,1,1,358,359,360,361,1,1,1,1,1,1,1,1,1,1,0,
1,1,1,1,1,1,1,1,1,1,1,1,338,339,340,341,1,1,1,1,1,1,1,1,1,1,0,
1,1,1,1,1,1,1,1,1,1,1,1,1,1,1,1,1,1,1,1,1,1,1,1,1,1,0,
1,1,1,1,1,1,1,1,1,1,1,1,1,1,1,1,1,1,1,1,1,1,1,1,1,1,0,
1,1,1,1,1,1,1,1,1,1,1,1,1,1,1,1,1,1,1,1,1,1,1,1,1,1,0,
1,1,1,1,1,1,1,1,1,1,1,1,1,1,1,1,1,1,1,1,1,1,1,1,1,1,0,
1,1,1,1,1,1,1,1,1,1,1,1,1,1,1,1,1,1,1,1,1,1,1,1,1,1,0,
1,1,1,1,1,1,1,1,1,1,1,1,1,1,1,1,1,1,1,1,1,1,1,1,1,1,0,
1,1,1,1,1,1,1,1,1,1,1,1,1,1,1,1,1,1,1,1,1,1,1,1,1,1,0,
1,1,1,1,1,1,1,1,1,1,1,1,1,1,1,1,1,1,1,1,1,1,1,1,1,1,0,
1,1,1,1,1,1,1,1,1,1,1,1,1,1,1,1,1,1,1,1,1,1,1,1,1,1,0,
0,0,0,0,0,0,0,0,0,0,0,0,0,0,0,0,0,0,0,0,0,0,0,0,0,0,0
],
"layer2":[]
}