{
    "height":14,
    "width":27,
    "cam_bump":0,
    "doors":[131, 157],
    "door_info":[{
      "map": 5,
      "x":16,
      "y":198,
      "destx": 802,
      "desty": 202
},
{
      "map": 5,
      "x":16,
      "y":198,
      "destx": 802,
      "desty": 202
}
      
    ],
    "layer0":[1,1,1,1,1,1,1,1,1,1,1,1,1,1,1,1,1,1,1,1,1,1,1,1,1,1,1,
1,1,1,1,1,1,1,1,282,283,283,283,283,283,283,283,283,284,1,1,1,1,1,1,1,1,1,
1,1,1,1,1,1,1,1,262,263,263,263,263,263,263,263,263,264,1,1,1,1,1,1,1,1,1,
1,1,1,1,1,1,1,1,262,263,263,263,263,263,263,263,263,264,1,1,1,1,1,1,1,1,1,
1,1,1,1,1,1,1,1,262,263,263,263,263,263,263,263,263,264,1,1,1,1,1,1,1,1,1,
283,283,283,283,283,283,283,283,263,263,263,263,263,263,263,263,263,263,283,283,283,283,283,283,283,283,1,
243,243,243,243,243,243,243,243,263,263,263,263,263,263,263,263,263,263,243,243,243,243,243,243,243,243,1,
391,391,391,391,391,391,391,392,242,243,243,243,243,243,243,243,243,244,390,391,391,391,391,391,391,391,1,
371,371,371,371,371,371,371,372,390,391,391,391,391,391,391,391,391,392,370,371,371,371,371,371,371,371,1,
371,371,371,371,371,371,371,372,370,371,371,371,371,371,371,371,371,372,370,371,371,371,371,371,371,371,1,
371,371,371,371,371,371,371,372,370,371,371,371,371,371,371,371,371,372,370,371,371,371,371,371,371,371,1,
351,351,351,351,351,351,351,352,370,371,371,371,371,371,371,371,371,372,350,351,351,351,351,351,351,351,1,
41,41,41,41,41,41,41,41,350,351,351,351,351,351,351,351,351,352,1,1,1,1,1,1,1,1,1,
1,1,1,1,1,1,1,1,1,1,1,1,1,1,1,1,1,1,1,1,1,1,1,1,1,1,1

],
"layer1": [1,1,1,1,1,1,1,1,1,1,1,1,1,1,1,1,1,1,1,1,1,1,1,1,1,1,1,
1,1,1,1,1,1,1,1,1,1,1,1,1,1,1,1,1,1,1,1,1,1,1,1,1,1,1,
1,1,1,1,1,1,1,1,1,1,1,1,1,1,1,368,369,1,1,1,1,1,1,1,1,1,1,
1,1,1,1,1,1,1,1,1,1,1,1,1,1,1,348,349,1,1,1,1,1,1,1,1,1,1,
1,1,1,1,1,1,1,1,1,1,1,1,1,1,1,1,1,1,1,1,1,1,1,1,1,1,1,
1,1,1,1,1,1,1,1,1,368,369,1,1,1,1,1,1,1,1,1,1,366,1,1,1,1,1,
1,1,1,1,1,1,1,1,1,348,349,1,1,1,1,1,1,1,1,1,366,346,1,1,1,1,1,
1,1,1,1,1,1,1,1,1,1,1,1,1,1,1,1,1,1,1,1,346,1,1,1,1,1,1,
1,1,1,1,1,1,1,1,1,1,1,318,319,320,321,1,1,1,1,1,1,1,1,1,1,1,1,
1,1,1,1,1,1,1,1,1,1,1,298,299,300,301,1,1,1,1,1,1,1,1,1,1,1,1,
1,1,1,1,1,1,1,1,1,1,1,278,279,280,281,1,1,1,1,1,1,1,1,1,1,1,1,
1,1,1,1,1,1,1,1,1,1,1,258,259,260,261,1,1,1,1,1,1,1,1,1,1,1,1,
1,1,1,1,1,1,1,1,1,1,1,1,1,1,1,1,1,1,1,1,1,1,1,1,1,1,1,
1,1,1,1,1,1,1,1,1,1,1,1,1,1,1,1,1,1,1,1,1,1,1,1,1,1,1

],
"layer2":[]
}