{
    "height":14,
    "width":23,
    "cam_bump":0,
    "doors":[161, 138],
    "door_info":[{
      "map": 5,
      "destx": 16,
      "desty": 202,
      "x":716,"y":206
      },
      {
      "map": 5,
      "destx": 16,
      "desty": 202,
      "x":716,"y":164}
    ],
    "layer0":[1,1,1,1,1,1,1,1,1,1,1,1,1,1,1,1,1,1,1,1,1,1,1,
1,1,1,1,1,1,1,1,1,1,1,1,1,1,1,1,1,1,1,1,1,1,1,
1,1,1,1,1,1,1,1,1,1,342,283,283,283,283,283,283,283,283,283,284,1,1,
1,1,1,1,1,1,1,1,1,1,322,263,263,263,263,263,263,263,263,263,264,1,1,
1,1,1,1,1,1,1,1,1,1,322,263,263,263,263,263,263,263,263,263,264,1,1,
1,1,1,1,1,1,1,1,1,1,322,263,263,263,263,263,263,263,263,263,263,283,1,
1,1,1,1,1,1,1,1,1,1,322,263,263,263,263,263,263,263,263,263,263,243,1,
1,1,1,1,1,1,1,1,1,1,322,263,263,263,263,263,263,263,263,263,264,1,1,
1,1,1,1,1,1,1,1,1,1,322,263,263,263,263,263,263,263,263,263,264,1,1,
1,1,1,1,1,1,1,1,1,1,302,243,243,243,243,243,243,243,243,243,244,1,1,
1,1,1,1,1,1,1,1,1,1,1,1,1,1,1,1,1,1,1,1,1,1,1,
1,1,1,1,1,1,1,1,1,1,1,1,1,1,1,1,1,1,1,1,1,1,1,
1,1,1,1,1,1,1,1,1,1,1,1,1,1,1,1,1,1,1,1,1,1,1,
1,1,1,1,1,1,1,1,1,1,1,1,1,1,1,1,1,1,1,1,1,1,1


],
"layer1": [1,1,1,1,1,1,1,1,1,1,1,1,1,1,1,1,1,1,1,1,1,1,1,
1,1,1,1,1,1,1,1,1,1,1,1,1,1,1,1,1,1,1,1,1,1,1,
1,1,1,1,1,1,1,1,1,1,1,1,1,1,1,1,1,1,1,1,1,1,1,
1,1,1,1,1,1,1,1,1,1,1,384,385,1,1,1,1,1,386,1,1,1,1,
1,1,1,1,1,1,1,1,1,1,1,364,365,1,1,1,1,1,1,1,1,1,1,
1,1,1,1,1,1,1,1,1,1,1,344,345,324,1,1,1,1,1,1,1,1,1,
1,1,1,1,1,1,1,1,1,1,1,1,1,1,1,1,1,1,1,1,1,1,1,
1,1,1,1,1,1,1,1,1,1,1,1,1,1,1,1,1,367,1,1,1,1,1,
1,1,1,1,1,1,1,1,1,1,1,1,327,328,329,1,1,368,369,1,1,1,1,
1,1,1,1,1,1,1,1,1,1,1,1,307,308,309,1,1,348,349,1,1,1,1,
1,1,1,1,1,1,1,1,1,1,1,1,1,1,1,1,1,1,1,1,1,1,1,
1,1,1,1,1,1,1,1,1,1,1,1,1,1,1,1,1,1,1,1,1,1,1,
1,1,1,1,1,1,1,1,1,1,1,1,1,1,1,1,1,1,1,1,1,1,1,
1,1,1,1,1,1,1,1,1,1,1,1,1,1,1,1,1,1,1,1,1,1,1
],
"layer2":[1,1,1,1,1,1,1,1,1,1,1,1,1,1,1,1,1,1,1,1,1,1,1,
1,1,1,1,1,1,1,1,1,1,1,1,1,1,1,1,1,1,1,1,1,1,1,
1,1,1,1,1,1,1,1,1,1,1,1,1,1,1,1,1,1,1,1,1,1,1,
1,1,1,1,1,1,1,1,1,1,1,1,1,1,1,1,1,1,1,1,1,1,1,
1,1,1,1,1,1,1,1,1,1,1,1,1,1,1,1,1,1,1,1,1,1,1,
1,1,1,1,1,1,1,1,1,1,1,1,1,1,1,1,1,1,1,1,1,1,1,
1,1,1,1,1,1,1,1,1,1,1,1,1,1,1,1,1,1,1,1,1,1,1,
1,1,1,1,1,1,1,1,1,1,1,1,1,1,1,1,1,1,1,1,1,1,1,
1,1,1,1,1,1,1,1,1,1,1,1,1,1,1,1,1,1,1,1,1,1,1,
1,1,1,1,1,1,1,1,1,1,1,1,1,1,1,1,1,382,383,1,1,1,1,
1,1,1,1,1,1,1,1,1,1,1,1,1,1,1,1,1,362,363,1,1,1,1,
1,1,1,1,1,1,1,1,1,1,1,1,1,1,1,1,1,1,1,1,1,1,1,
1,1,1,1,1,1,1,1,1,1,1,1,1,1,1,1,1,1,1,1,1,1,1,
1,1,1,1,1,1,1,1,1,1,1,1,1,1,1,1,1,1,1,1,1,1,1
]
}