{
    "height":13,
    "width":22,
    "cam_bump":0,
    "doors":[],
    "door_info":[{
      "map": 5,
      "destx": 815,
      "desty": 202,
      "x":698,
      "y":192
      },
      {
      "map": 5,
      "destx": 815,
      "desty": 202,
      "x":698,
      "y":192}
    ],
    "layer0":[1,1,1,1,1,1,1,1,1,1,1,1,1,1,1,1,1,1,1,1,1,1,
1,1,1,1,1,1,1,1,1,1,1,1,1,1,1,1,1,1,1,1,1,1,
1,1,1,1,1,1,1,1,1,1,342,283,283,283,283,283,283,283,283,283,284,1,
1,1,1,1,1,1,1,1,1,1,322,263,263,263,263,263,263,263,263,263,264,1,
1,1,1,1,1,1,1,1,1,1,322,263,263,263,263,263,263,263,263,263,264,1,
1,1,1,1,1,1,1,1,1,1,322,263,263,263,263,263,263,263,263,263,263,283,
1,1,1,1,1,1,1,1,1,1,322,263,263,263,263,263,263,263,263,263,263,243,
1,1,1,1,1,1,1,1,1,1,322,263,263,263,263,263,263,263,263,263,264,1,
1,1,1,1,1,1,1,1,1,1,322,263,263,263,263,263,263,263,263,263,264,1,
1,1,1,1,1,1,1,1,1,1,302,243,243,243,243,243,243,243,243,243,244,1,
1,1,1,1,1,1,1,1,1,1,1,1,1,1,1,1,1,1,1,1,1,1,
1,1,1,1,1,1,1,1,1,1,1,1,1,1,1,1,1,1,1,1,1,1,
1,1,1,1,1,1,1,1,1,1,1,1,1,1,1,1,1,1,1,1,1,1


],
"layer1": [1,1,1,1,1,1,1,1,1,1,1,1,1,1,1,1,1,1,1,1,1,1,
1,1,1,1,1,1,1,1,1,1,1,1,1,1,1,1,1,1,1,1,1,1,
1,1,1,1,1,1,1,1,1,1,1,1,1,1,1,1,1,1,1,1,1,1,
1,1,1,1,1,1,1,1,1,1,1,384,385,1,1,1,1,1,1,1,1,1,
1,1,1,1,1,1,1,1,1,1,1,364,365,1,1,1,1,1,1,1,1,1,
1,1,1,1,1,1,1,1,1,1,1,344,345,324,1,1,1,1,1,1,1,1,
1,1,1,1,1,1,1,1,1,1,1,1,1,1,1,1,1,1,1,1,1,1,
1,1,1,1,1,1,1,1,1,1,1,1,1,1,1,1,1,367,1,1,1,1,
1,1,1,1,1,1,1,1,1,1,1,1,1,1,1,1,1,368,369,1,1,1,
1,1,1,1,1,1,1,1,1,1,1,1,1,1,1,1,1,348,349,1,1,1,
1,1,1,1,1,1,1,1,1,1,1,1,1,1,1,1,1,1,1,1,1,1,
1,1,1,1,1,1,1,1,1,1,1,1,1,1,1,1,1,1,1,1,1,1,
1,1,1,1,1,1,1,1,1,1,1,1,1,1,1,1,1,1,1,1,1,1

],
"layer2":[0,0,0,0,0,0,0,0,0,0,0,0,0,0,0,0,0,0,0,0,0,0,
0,0,0,0,0,0,0,0,0,0,0,0,0,0,0,0,0,0,0,0,0,0,
0,0,0,0,0,0,0,0,0,0,0,0,0,0,0,0,0,0,0,0,0,0,
0,0,0,0,0,0,0,0,0,0,0,0,0,0,0,0,0,0,0,386,0,0,
0,0,0,0,0,0,0,0,0,0,0,0,0,0,0,0,0,0,0,0,0,0,
0,0,0,0,0,0,0,0,0,0,0,0,0,0,0,0,0,0,0,0,0,0,
0,0,0,0,0,0,0,0,0,0,0,0,0,0,0,0,0,0,0,0,0,0,
0,0,0,0,0,0,0,0,0,0,0,0,0,0,0,0,0,0,0,0,0,0,
0,0,0,0,0,0,0,0,0,0,0,0,327,328,329,0,0,0,0,0,0,0,
0,0,0,0,0,0,0,0,0,0,0,0,307,308,309,0,0,382,383,0,0,0,
0,0,0,0,0,0,0,0,0,0,0,0,0,0,0,0,0,362,363,0,0,0,
0,0,0,0,0,0,0,0,0,0,0,0,0,0,0,0,0,0,0,0,0,0,
0,0,0,0,0,0,0,0,0,0,0,0,0,0,0,0,0,0,0,0,0,0
]
}