{"height": 33,
 "width": 25,
  "cam_bump": 0,
  "doors": [812, 813, 814, 815],
  "door_info": [
    {"map": 8, "destx": 224, "desty": 26, "x":374,"y":1028},
    {"map": 8, "destx": 224, "desty": 26, "x":376,"y":1028},
    {"map": 8, "destx": 224, "desty": 26, "x":418,"y":1028},
    {"map": 8, "destx": 224, "desty": 26, "x":462,"y":1028}
  ], 
  "interact":[284, 268],
  "interact_id":[1, 2],
  "interact_infos":[
    {"type":"text","content":[{"text":"The window looks out into the horizon...","face":""}, {"text":"There's too much grime on the glass to properly tell whats out there.","face":""}]},
    {"type":"text","content":[{"text":"It's a strange looking trash can.","face":""}, {"text":"Hey! I put a lot of effort into that!","face":"saggle_sparkle"}, {"text":"...","face":"p_lookdown"},{"text":"(Why is this egg talking to himself?)","face":"p_somber"}]}
    
  ],
  "entities":[
    {"id":"saggle","x":284,"y":334,"size":32, "interact_events":[
      {"type":"text", "content":[{"text":"Man, isn't the dreamworld just great?","face":"saggle_sparkle"},{"text":"There are so many cool people here, I just can't believe it!","face":"saggle_left"},{"text":"It would be such a shame if someone died!","face":"saggle_right"}]}
    ]}
  ],

  "layer0": [
  0,0,0,0,0,0,1,1,1,1,1,1,1,1,1,1,1,1,1,1,1,0,0,0,0,
0,0,0,0,0,0,1,45,46,46,46,46,46,46,46,46,46,46,47,1,1,0,0,0,0,
0,0,0,0,0,0,1,25,26,26,26,26,26,26,26,26,26,26,27,1,1,0,0,0,0,
0,0,0,0,0,0,1,25,26,26,26,26,26,26,26,26,26,26,27,1,1,0,0,0,0,
0,0,0,0,0,0,1,25,26,26,26,26,26,26,26,26,26,26,27,1,1,0,0,0,0,
0,0,0,0,0,0,1,25,26,26,26,26,26,26,26,26,26,26,27,1,1,0,0,0,0,
0,0,0,0,0,0,1,25,26,26,26,26,26,26,26,26,26,26,27,1,1,0,0,0,0,
0,0,0,0,0,0,1,25,26,26,26,26,26,26,26,26,26,26,27,1,1,0,0,0,0,
0,0,0,0,0,0,1,25,26,26,26,26,26,26,26,26,26,26,27,1,1,0,0,0,0,
0,0,0,0,0,0,1,25,26,26,26,26,26,26,26,26,26,26,27,1,1,0,0,0,0,
0,0,0,0,0,0,1,5,6,6,6,26,26,26,26,6,6,6,7,1,1,0,0,0,0,
0,0,0,0,0,0,1,74,75,75,76,25,26,26,27,74,75,75,76,1,1,0,0,0,0,
0,0,0,0,0,0,1,54,55,55,56,25,26,26,27,54,55,55,56,1,1,0,0,0,0,
0,0,0,0,0,0,1,34,35,35,36,25,26,26,27,34,35,35,36,1,1,0,0,0,0,
0,0,0,0,0,0,1,14,15,15,16,25,26,26,27,14,15,15,16,1,1,0,0,0,0,
0,0,0,0,0,0,1,1,1,1,1,25,26,26,27,1,1,1,1,1,1,0,0,0,0,
0,0,0,0,0,0,1,1,1,1,1,25,26,26,27,1,1,1,1,1,1,0,0,0,0,
0,0,0,0,0,0,1,1,1,1,1,25,26,26,27,1,1,1,1,1,1,0,0,0,0,
0,0,0,0,0,0,1,1,1,1,1,25,26,26,27,1,1,1,1,1,1,0,0,0,0,
0,0,0,0,0,0,1,1,1,1,1,25,26,26,27,1,1,1,1,1,1,0,0,0,0,
0,0,0,0,0,0,1,1,1,1,1,25,26,26,27,1,1,1,1,1,1,0,0,0,0,
0,0,0,0,0,0,1,1,1,1,1,25,26,26,27,1,1,1,1,1,1,0,0,0,0,
0,0,0,0,0,0,1,1,1,1,1,25,26,26,27,1,1,1,1,1,1,0,0,0,0,
0,0,0,0,0,0,1,1,1,1,1,25,26,26,27,1,1,1,1,1,1,0,0,0,0,
0,0,0,0,0,0,1,1,1,1,1,25,26,26,27,1,1,1,1,1,1,0,0,0,0,
0,0,0,0,0,0,1,1,1,1,1,25,26,26,27,1,1,1,1,1,1,0,0,0,0,
0,0,0,0,0,0,1,1,1,1,1,25,26,26,27,1,1,1,1,1,1,0,0,0,0,
0,0,0,0,0,0,1,1,1,1,1,25,26,26,27,1,1,1,1,1,1,0,0,0,0,
0,0,0,0,0,0,1,1,1,1,1,25,26,26,27,1,1,1,1,1,1,0,0,0,0,
0,0,0,0,0,0,1,1,1,1,1,25,26,26,27,1,1,1,1,1,1,0,0,0,0,
0,0,0,0,0,0,1,1,1,1,1,25,26,26,27,1,1,1,1,1,1,0,0,0,0,
0,0,0,0,0,0,1,1,1,1,1,25,26,26,27,1,1,1,1,1,1,0,0,0,0,
0,0,0,0,0,0,1,1,1,1,1,1,1,1,1,1,1,1,1,1,1,0,0,0,0
],

  "layer1": [
0,0,0,0,0,0,1,1,1,1,1,1,1,1,1,1,1,1,1,1,1,0,0,0,0,
0,0,0,0,0,0,1,1,1,1,1,1,1,1,1,1,1,1,1,1,1,0,0,0,0,
0,0,0,0,0,0,1,1,1,1,105,106,106,106,106,107,1,1,1,1,1,0,0,0,0,
0,0,0,0,0,0,1,1,1,1,85,86,86,86,86,87,1,1,1,1,1,0,0,0,0,
0,0,0,0,0,0,1,1,1,1,85,86,86,86,86,87,1,1,1,1,1,0,0,0,0,
0,0,0,0,0,0,1,1,1,1,85,86,86,86,86,87,1,1,1,1,1,0,0,0,0,
0,0,0,0,0,0,1,1,1,1,85,86,86,86,86,87,1,1,1,1,1,0,0,0,0,
0,0,0,0,0,0,1,1,1,1,85,86,86,86,86,87,1,1,1,1,1,0,0,0,0,
0,0,0,0,0,0,1,1,1,1,65,66,86,86,66,67,1,1,1,1,1,0,0,0,0,
0,0,0,0,0,0,1,1,1,1,1,1,85,87,1,1,1,1,1,1,1,0,0,0,0,
0,0,0,0,0,0,1,1,1,1,1,1,85,87,1,1,1,114,1,1,1,0,0,0,0,
0,0,0,0,0,0,1,1,1,1,1,1,85,87,1,1,1,94,1,1,1,0,0,0,0,
0,0,0,0,0,0,1,1,37,38,1,1,85,87,1,1,1,1,1,1,1,0,0,0,0,
0,0,0,0,0,0,1,1,17,18,1,1,85,87,1,1,1,1,1,1,1,0,0,0,0,
0,0,0,0,0,0,1,1,1,1,1,1,85,87,1,1,1,1,1,1,1,0,0,0,0,
0,0,0,0,0,0,1,1,1,1,1,1,85,87,1,1,1,1,1,1,1,0,0,0,0,
0,0,0,0,0,0,1,1,1,1,1,1,85,87,1,1,1,1,1,1,1,0,0,0,0,
0,0,0,0,0,0,1,1,1,1,1,1,85,87,1,1,1,1,1,1,1,0,0,0,0,
0,0,0,0,0,0,1,1,1,1,1,1,85,87,1,1,1,1,1,1,1,0,0,0,0,
0,0,0,0,0,0,1,1,1,1,1,1,85,87,1,1,1,1,1,1,1,0,0,0,0,
0,0,0,0,0,0,1,1,1,1,1,1,85,87,1,1,1,1,1,1,1,0,0,0,0,
0,0,0,0,0,0,1,1,1,1,1,1,85,87,1,1,1,1,1,1,1,0,0,0,0,
0,0,0,0,0,0,1,1,1,1,1,1,85,87,1,1,1,1,1,1,1,0,0,0,0,
0,0,0,0,0,0,1,1,1,1,1,1,85,87,1,1,1,1,1,1,1,0,0,0,0,
0,0,0,0,0,0,1,1,1,1,1,1,85,87,1,1,1,1,1,1,1,0,0,0,0,
0,0,0,0,0,0,1,1,1,1,1,1,85,87,1,1,1,1,1,1,1,0,0,0,0,
0,0,0,0,0,0,1,1,1,1,1,1,85,87,1,1,1,1,1,1,1,0,0,0,0,
0,0,0,0,0,0,1,1,1,1,1,1,85,87,1,1,1,1,1,1,1,0,0,0,0,
0,0,0,0,0,0,1,1,1,1,1,1,85,87,1,1,1,1,1,1,1,0,0,0,0,
0,0,0,0,0,0,1,1,1,1,1,1,85,87,1,1,1,1,1,1,1,0,0,0,0,
0,0,0,0,0,0,1,1,1,1,1,1,85,87,1,1,1,1,1,1,1,0,0,0,0,
0,0,0,0,0,0,1,1,1,1,1,1,85,87,1,1,1,1,1,1,1,0,0,0,0,
0,0,0,0,0,0,1,1,1,1,1,1,1,1,1,1,1,1,1,1,1,0,0,0,0
],
  "layer2": [
0,0,0,0,0,0,49,8,8,8,8,8,8,8,8,8,8,8,8,50,1,0,0,0,0,
0,0,0,0,0,0,29,1,1,1,1,1,1,1,1,1,1,1,1,52,1,0,0,0,0,
0,0,0,0,0,0,29,1,1,1,1,1,1,1,1,1,1,1,1,52,1,0,0,0,0,
0,0,0,0,0,0,29,1,1,1,1,1,1,1,1,1,1,1,1,52,1,0,0,0,0,
0,0,0,0,0,0,29,1,1,1,1,1,1,1,1,1,1,1,1,52,1,0,0,0,0,
0,0,0,0,0,0,29,1,1,1,1,1,1,1,1,1,1,1,1,52,1,0,0,0,0,
0,0,0,0,0,0,29,1,1,1,1,1,1,1,1,1,1,1,1,52,1,0,0,0,0,
0,0,0,0,0,0,29,1,1,1,1,1,1,1,1,1,1,1,1,52,1,0,0,0,0,
0,0,0,0,0,0,29,1,1,1,1,1,1,1,1,1,1,1,1,52,1,0,0,0,0,
0,0,0,0,0,0,29,1,1,1,1,1,1,1,1,1,1,1,1,52,1,0,0,0,0,
0,0,0,0,0,0,29,1,1,1,1,1,1,1,1,1,1,1,1,52,1,0,0,0,0,
0,0,0,0,0,0,29,1,1,1,1,1,1,1,1,1,1,1,1,52,1,0,0,0,0,
0,0,0,0,0,0,29,1,1,1,1,1,1,1,1,1,1,1,1,52,1,0,0,0,0,
0,0,0,0,0,0,29,1,1,1,1,1,1,1,1,1,1,1,1,52,1,0,0,0,0,
0,0,0,0,0,0,29,1,1,1,1,1,1,1,1,1,1,1,1,52,1,0,0,0,0,
0,0,0,0,0,0,51,53,53,53,28,1,1,1,1,30,53,53,53,48,1,0,0,0,0,
0,0,0,0,0,0,1,1,1,1,29,1,1,1,1,52,1,1,1,1,1,0,0,0,0,
0,0,0,0,0,0,1,1,1,1,29,1,1,1,1,52,1,1,1,1,1,0,0,0,0,
0,0,0,0,0,0,1,1,1,1,29,1,1,1,1,52,1,1,1,1,1,0,0,0,0,
0,0,0,0,0,0,1,1,1,1,29,1,1,1,1,52,1,1,1,1,1,0,0,0,0,
0,0,0,0,0,0,1,1,1,1,29,1,1,1,1,52,1,1,1,1,1,0,0,0,0,
0,0,0,0,0,0,1,1,1,1,29,1,1,1,1,52,1,1,1,1,1,0,0,0,0,
0,0,0,0,0,0,1,1,1,1,29,1,1,1,1,52,1,1,1,1,1,0,0,0,0,
0,0,0,0,0,0,1,1,1,1,29,1,1,1,1,52,1,1,1,1,1,0,0,0,0,
0,0,0,0,0,0,1,1,1,1,29,1,1,1,1,52,1,1,1,1,1,0,0,0,0,
0,0,0,0,0,0,1,1,1,1,29,1,1,1,1,52,1,1,1,1,1,0,0,0,0,
0,0,0,0,0,0,1,1,1,1,29,1,1,1,1,52,1,1,1,1,1,0,0,0,0,
0,0,0,0,0,0,1,1,1,1,29,1,1,1,1,52,1,1,1,1,1,0,0,0,0,
0,0,0,0,0,0,1,1,1,1,29,1,1,1,1,52,1,1,1,1,1,0,0,0,0,
0,0,0,0,0,0,1,1,1,1,29,1,1,1,1,52,1,1,1,1,1,0,0,0,0,
0,0,0,0,0,0,1,1,1,1,29,1,1,1,1,52,1,1,1,1,1,0,0,0,0,
0,0,0,0,0,0,1,1,1,1,29,1,1,1,1,52,1,1,1,1,1,0,0,0,0,
0,0,0,0,0,0,1,1,1,1,1,1,1,1,1,1,1,1,1,1,1,0,0,0,0
]}