{"height": 39,
 "width": 23,
  "cam_bump": 0,
  "doors": [622, 599, 576, 553, 530,884,885,886,887,888,-13,-12,-11,-10,-9],
  "door_info": [
    {"map": 10, "destx": 1210, "desty": 372, "x":-16, "y":878},
    {"map": 10, "destx": 1210, "desty": 372, "x":-16, "y":848},
    {"map": 10, "destx": 1210, "desty": 372, "x":-16, "y":820},
    {"map": 10, "destx": 1210, "desty": 372, "x":-16, "y":790},
    {"map": 10, "destx": 1210, "desty": 372, "x":-16, "y":760},
    {"map": 2, "destx": 428, "desty": 18, "x":310,"y":1200},
    {"map": 2, "destx": 428, "desty": 18, "x":332,"y":1200},
    {"map": 2, "destx": 454, "desty": 18, "x":348,"y":1200},
    {"map": 2, "destx": 480, "desty": 18, "x":388,"y":1200},
    {"map": 2, "destx": 480, "desty": 18, "x":428,"y":1200},
    {
      "map": 8,
      "x":310,"y":-22,
      "destx":936,"desty":660

    },
    {
      "map": 8,
      "x":332,"y":-22,
      "destx":978,"desty":660

    },
    {
      "map": 8,
      "x":348,"y":-22,
      "destx":1014,"desty":660

    },
    {
      "map": 8,
      "x":388,"y":-22,
      "destx":1014,"desty":660

    },
    {
      "map": 8,
      "x":428,"y":-22,
      "destx":1014,"desty":660

    }
], 
  "interact":[],
  "interact_id":[],
  "interact_infos":[
  ],
  "entities":[
  ],

  "layer0": [
0,0,0,0,0,0,0,0,0,25,26,26,26,27,0,0,0,0,0,0,0,0,0,
0,0,0,0,0,0,0,0,0,25,26,26,26,27,0,0,0,0,0,0,0,0,0,
0,0,0,0,0,0,0,0,0,25,26,26,26,27,0,0,0,0,0,0,0,0,0,
0,0,0,0,0,0,0,0,0,25,26,26,26,27,0,0,0,0,0,0,0,0,0,
0,0,0,0,0,0,0,0,0,25,26,26,26,27,0,0,0,0,0,0,0,0,0,
0,0,0,0,0,0,0,0,0,25,26,26,26,27,0,0,0,0,0,0,0,0,0,
0,0,0,0,0,0,0,0,0,25,26,26,26,27,0,0,0,0,0,0,0,0,0,
0,0,0,0,0,0,0,0,0,25,26,26,26,27,0,0,0,0,0,0,0,0,0,
0,0,0,0,0,0,0,0,0,25,26,26,26,27,0,0,0,0,0,0,0,0,0,
0,0,0,0,0,0,0,0,0,25,26,26,26,27,0,0,0,0,0,0,0,0,0,
0,0,0,0,0,0,0,0,0,25,26,26,26,27,0,0,0,0,0,0,0,0,0,
0,0,0,0,0,0,0,0,0,25,26,26,26,27,0,0,0,0,0,0,0,0,0,
0,0,0,0,0,0,0,0,0,25,26,26,26,27,0,0,0,0,0,0,0,0,0,
0,0,0,0,0,0,0,0,0,25,26,26,26,27,0,0,0,0,0,0,0,0,0,
0,0,0,0,0,0,0,0,0,25,26,26,26,27,0,0,0,0,0,0,0,0,0,
0,0,0,0,0,0,0,0,0,25,26,26,26,27,0,0,0,0,0,0,0,0,0,
0,0,0,0,0,0,0,0,0,25,26,26,26,27,0,0,0,0,0,0,0,0,0,
0,0,0,0,0,0,0,0,0,25,26,26,26,27,0,0,0,0,0,0,0,0,0,
0,0,0,0,0,0,0,0,0,25,26,26,26,27,0,0,0,0,0,0,0,0,0,
0,0,0,0,0,0,0,0,0,25,26,26,26,27,0,0,0,0,0,0,0,0,0,
0,0,0,0,0,0,0,0,0,25,26,26,26,27,0,0,0,0,0,0,0,0,0,
0,0,0,0,0,0,0,0,0,25,26,26,26,27,0,0,0,0,0,0,0,0,0,
0,0,0,0,0,0,0,0,0,25,26,26,26,27,0,0,0,0,0,0,0,0,0,
46,46,46,46,46,46,46,46,46,26,26,26,26,27,0,0,0,0,0,0,0,0,0,
26,26,26,26,26,26,26,26,26,26,26,26,26,27,0,0,0,0,0,0,0,0,0,
26,26,26,26,26,26,26,26,26,26,26,26,26,27,0,0,0,0,0,0,0,0,0,
26,26,26,26,26,26,26,26,26,26,26,26,26,27,0,0,0,0,0,0,0,0,0,
6,6,6,6,6,6,6,6,6,26,26,26,26,27,0,0,0,0,0,0,0,0,0,
74,75,75,75,75,75,75,75,76,25,26,26,26,27,0,0,0,0,0,0,0,0,0,
54,55,55,55,55,55,55,55,56,25,26,26,26,27,0,0,0,0,0,0,0,0,0,
31,35,35,35,35,35,35,35,36,25,26,26,26,27,0,0,0,0,0,0,0,0,0,
14,15,15,15,15,15,15,15,13,25,26,26,26,27,0,0,0,0,0,0,0,0,0,
0,0,0,0,0,0,0,0,0,25,26,26,26,27,0,0,0,0,0,0,0,0,0,
0,0,0,0,0,0,0,0,0,25,26,26,26,27,0,0,0,0,0,0,0,0,0,
0,0,0,0,0,0,0,0,0,25,26,26,26,27,0,0,0,0,0,0,0,0,0,
0,0,0,0,0,0,0,0,0,25,26,26,26,27,0,0,0,0,0,0,0,0,0,
0,0,0,0,0,0,0,0,0,25,26,26,26,27,0,0,0,0,0,0,0,0,0,
0,0,0,0,0,0,0,0,0,25,26,26,26,27,0,0,0,0,0,0,0,0,0,
0,0,0,0,0,0,0,0,0,25,26,26,26,27,0,0,0,0,0,0,0,0,0
],

  "layer1": [
0,0,0,0,0,0,0,0,0,0,85,86,87,0,0,0,0,0,0,0,0,0,0,
0,0,0,0,0,0,0,0,0,0,85,86,87,0,0,0,0,0,0,0,0,0,0,
0,0,0,0,0,0,0,0,0,0,85,86,87,0,0,0,0,0,0,0,0,0,0,
0,0,0,0,0,0,0,0,0,0,85,86,87,0,0,0,0,0,0,0,0,0,0,
0,0,0,0,0,0,0,0,0,0,85,86,87,0,0,0,0,0,0,0,0,0,0,
0,0,0,0,0,0,0,0,0,0,85,86,87,0,0,0,0,0,0,0,0,0,0,
0,0,0,0,0,0,0,0,0,0,85,86,87,0,0,0,0,0,0,0,0,0,0,
0,0,0,0,0,0,0,0,0,0,85,86,87,0,0,0,0,0,0,0,0,0,0,
0,0,0,0,0,0,0,0,0,0,85,86,87,0,0,0,0,0,0,0,0,0,0,
0,0,0,0,0,0,0,0,0,0,85,86,87,0,0,0,0,0,0,0,0,0,0,
0,0,0,0,0,0,0,0,0,0,85,86,87,0,0,0,0,0,0,0,0,0,0,
0,0,0,0,0,0,0,0,0,0,85,86,87,0,0,0,0,0,0,0,0,0,0,
0,0,0,0,0,0,0,0,0,0,85,86,87,0,0,0,0,0,0,0,0,0,0,
0,0,0,0,0,0,0,0,0,0,85,86,87,0,0,0,0,0,0,0,0,0,0,
0,0,0,0,0,0,0,0,0,0,85,86,87,0,0,0,0,0,0,0,0,0,0,
0,0,0,0,0,0,0,0,0,0,85,86,87,0,0,0,0,0,0,0,0,0,0,
0,0,0,0,0,0,0,0,0,0,85,86,87,0,0,0,0,0,0,0,0,0,0,
0,0,0,0,0,0,0,0,0,0,85,86,87,0,0,0,0,0,0,0,0,0,0,
0,0,0,0,0,0,0,0,0,0,85,86,87,0,0,0,0,0,0,0,0,0,0,
0,0,0,0,0,0,0,0,0,0,85,86,87,0,0,0,0,0,0,0,0,0,0,
0,0,0,0,0,0,0,0,0,0,85,86,87,0,0,0,0,0,0,0,0,0,0,
0,0,0,0,0,0,0,0,0,0,85,86,87,0,0,0,0,0,0,0,0,0,0,
0,0,0,0,0,0,0,0,0,0,85,86,87,0,0,0,0,0,0,0,0,0,0,
0,0,0,0,0,0,0,0,0,0,85,86,87,0,0,0,0,0,0,0,0,0,0,
106,106,106,106,106,106,106,106,106,106,86,86,87,0,0,0,0,0,0,0,0,0,0,
86,86,86,86,86,86,86,86,86,86,86,86,87,0,0,0,0,0,0,0,0,0,0,
66,66,66,66,66,66,66,66,66,66,86,86,87,0,0,0,0,0,0,0,0,0,0,
0,0,0,0,0,0,0,0,0,0,85,86,87,0,0,0,0,0,0,0,0,0,0,
0,0,0,0,0,0,0,0,0,0,85,86,87,0,0,0,0,0,0,0,0,0,0,
0,0,0,0,0,0,0,0,0,0,85,86,87,0,0,0,0,0,0,0,0,0,0,
0,0,0,0,0,0,0,0,0,0,85,86,87,0,0,0,0,0,0,0,0,0,0,
0,0,0,0,0,0,0,0,0,0,85,86,87,0,0,0,0,0,0,0,0,0,0,
0,0,0,0,0,0,0,0,0,0,85,86,87,0,0,0,0,0,0,0,0,0,0,
0,0,0,0,0,0,0,0,0,0,85,86,87,0,0,0,0,0,0,0,0,0,0,
0,0,0,0,0,0,0,0,0,0,85,86,87,0,0,0,0,0,0,0,0,0,0,
0,0,0,0,0,0,0,0,0,0,85,86,87,0,0,0,0,0,0,0,0,0,0,
0,0,0,0,0,0,0,0,0,0,85,86,87,0,0,0,0,0,0,0,0,0,0,
0,0,0,0,0,0,0,0,0,0,85,86,87,0,0,0,0,0,0,0,0,0,0,
0,0,0,0,0,0,0,0,0,0,85,86,87,0,0,0,0,0,0,0,0,0,0
],
  "layer2": [
0,0,0,0,0,0,0,0,29,0,0,0,0,0,52,0,0,0,0,0,0,0,0,
0,0,0,0,0,0,0,0,29,0,0,0,0,0,52,0,0,0,0,0,0,0,0,
0,0,0,0,0,0,0,0,29,0,0,0,0,0,52,0,0,0,0,0,0,0,0,
0,0,0,0,0,0,0,0,29,0,0,0,0,0,52,0,0,0,0,0,0,0,0,
0,0,0,0,0,0,0,0,29,0,0,0,0,0,52,0,0,0,0,0,0,0,0,
0,0,0,0,0,0,0,0,29,0,0,0,0,0,52,0,0,0,0,0,0,0,0,
0,0,0,0,0,0,0,0,29,0,0,0,0,0,52,0,0,0,0,0,0,0,0,
0,0,0,0,0,0,0,0,29,0,0,0,0,0,52,0,0,0,0,0,0,0,0,
0,0,0,0,0,0,0,0,29,0,0,0,0,0,52,0,0,0,0,0,0,0,0,
0,0,0,0,0,0,0,0,29,0,0,0,0,0,52,0,0,0,0,0,0,0,0,
0,0,0,0,0,0,0,0,29,0,0,0,0,0,52,0,0,0,0,0,0,0,0,
0,0,0,0,0,0,0,0,29,0,0,0,0,0,52,0,0,0,0,0,0,0,0,
0,0,0,0,0,0,0,0,29,0,0,0,0,0,52,0,0,0,0,0,0,0,0,
0,0,0,0,0,0,0,0,29,0,0,0,0,0,52,0,0,0,0,0,0,0,0,
0,0,0,0,0,0,0,0,29,0,0,0,0,0,52,0,0,0,0,0,0,0,0,
0,0,0,0,0,0,0,0,29,0,0,0,0,0,52,0,0,0,0,0,0,0,0,
0,0,0,0,0,0,0,0,29,0,0,0,0,0,52,0,0,0,0,0,0,0,0,
0,0,0,0,0,0,0,0,29,0,0,0,0,0,52,0,0,0,0,0,0,0,0,
0,0,0,0,0,0,0,0,29,0,0,0,0,0,52,0,0,0,0,0,0,0,0,
0,0,0,0,0,0,0,0,29,0,0,0,0,0,52,0,0,0,0,0,0,0,0,
0,0,0,0,0,0,0,0,29,0,0,0,1,0,52,0,0,0,0,0,0,0,0,
0,0,0,0,0,0,0,0,29,0,0,0,1,0,52,0,0,0,0,0,0,0,0,
8,8,8,8,8,8,8,8,9,0,0,0,0,0,52,0,0,0,0,0,0,0,0,
0,0,0,0,0,0,0,0,1,0,0,0,0,0,52,0,0,0,0,0,0,0,0,
0,0,0,0,0,0,0,0,1,0,0,1,0,0,52,0,0,0,0,0,0,0,0,
0,0,0,0,0,0,0,0,1,0,0,1,0,0,52,0,0,0,0,0,0,0,0,
0,0,0,0,0,0,0,0,1,0,0,1,0,0,52,0,0,0,0,0,0,0,0,
0,0,0,0,0,0,0,0,1,0,0,1,0,0,52,0,0,0,0,0,0,0,0,
1,1,1,1,1,1,1,1,1,1,1,1,0,0,52,0,0,0,0,0,0,0,0,
0,0,0,0,0,0,0,0,1,1,1,0,0,0,52,0,0,0,0,0,0,0,0,
0,0,0,0,0,0,0,0,1,1,1,0,0,0,52,0,0,0,0,0,0,0,0,
0,0,0,0,0,0,0,0,1,0,0,0,0,0,52,0,0,0,0,0,0,0,0,
0,0,0,0,0,0,0,0,29,0,0,0,0,0,52,0,0,0,0,0,0,0,0,
0,0,0,0,0,0,0,0,29,0,0,0,0,0,52,0,0,0,0,0,0,0,0,
0,0,0,0,0,0,0,0,29,0,0,0,0,0,52,0,0,0,0,0,0,0,0,
0,0,0,0,0,0,0,0,29,0,0,0,0,0,52,0,0,0,0,0,0,0,0,
0,0,0,0,0,0,0,0,29,0,0,0,0,0,52,0,0,0,0,0,0,0,0,
0,0,0,0,0,0,0,0,29,0,0,0,0,0,52,0,0,0,0,0,0,0,0,
0,0,0,0,0,0,0,0,29,0,0,0,0,0,52,0,0,0,0,0,0,0,0
]}
